 acquaintance=знакомый
 generous=щедрый
 enthusiasm=энтузиазм
 bitterly=горько
 shy=застенчивый
 acquaintance=знакомый
 generous=щедрый
 enthusiasm=энтузиазм
 bitterly=горько
 shy=застенчивый
 outstanding=выдающийся
 dangerous=опасно
 upset=расстроен
 experience=опыт
 wedding=свадьба
 amazing=удивительно
 hospitable=гостеприимный
 quite=довольно
 available=доступно
 accustomed=привык
 achievement=достижение
 confident=уверенный
 certain=уверен(certain)
 sure=уверен(sure)
 recommendation=рекомендация
 lonely=одинокий
 mistake=ошибка
 attempt=попытка
 impressive=впечатляющий
 curious=любопытно
 cloudy=облачно
 ill=болезнь
 absent=отсутствовать
 threat=угроза
 unlikely=маловероятно
 ahead=впереди
 courageously=отважно
 alternative=альтернатива
 thoughtful=задумчивый
 initiative=инициатива
 month=месяц
 excellent=отлично
 sensation=сенсация
 seriously=серьёзно
 thrilling=захватывающий
 professional=профессионально
 necessary=необходимо
 spacious=просторно
 intention=намерение
 intent=намереваться
 fault=вина
 disturb=мешать
 guarantee=гарантировать
 deserve=заслужить
 boast=хвастаться
 thin=тонко
 thick=толстый
 regularly=регулярно
 puck=паковать
 clothes=одежда
 react to=реагировать
 contest=соревнование
 healthy=здоровый
 guess=угадать
 put on=одевать
 coat=пальто
 hungry=голоден
 angry=злой
 indefinite=неопределённый
 as you know=как ты знаешь
 as i remember=как я помню
 as i guess=как я догадываюсь
 sooner or later=рано или поздно
 even=даже
 between=между
 few=мало
 a few=несколько
 each of you=каждый из вас
 government=правительство
 authorities=власти
 law=закон
 others=другие
 trust=доверять
 research=исследовать
 scientific=научный
 by myself/on my own=самостоятельно
 towards=по направлению
 through=через
 look for=искать
 sense of humor=чувство юмора
 include=включать что-то в себя
 including=включая в себя
 machine=машина
 economic=экономика (страны)
 economical=сэкономить
 interact=взаимодействовать
 rudimentary=элементарный
 brief=краткое
 thrust=толкать
 represent=представляет
 retrieve=извлекать
 unit=еденица
 generally=в целом
 consequence=последствие
 compute=вычислять
 evaluate=оценивать
 for instance=например
 crucial=решающий
 especially=особенно
 society=общество
 won't take place=не произойдёт
 fee=платёж
 taxes=налоги
 costs=расходы
 cover=покрыть
 income=доход
 directly=прямо
 agreement=соглашение
 own=владеть
 owner=собственник
 prove=доказывать
 analysis=анализ
 elections=выборы
 while=в то время как
 community=сообщество
 badminton=бадминтон
 try on=примерять
 look up=посмотреть(в словаре)
 invitation=приглашение
 below=ниже
 above=выше
 timetable=расписание
 schedule=график
 insurance=страховка
 spelling mistake=орфографическая ошибка
 advertisement=реклама
 compete=соревноваться/конкурировать
 round robin=по-круговой
 faces off=сталкиваться лицом к лицу
 designate=назначать
 tie=ничья
 respectively=соответственно
 corresponding=соответствующий
 specifically=а именно
 denotes=означает
 exactly=ровно/точно
 gibberish=неграмнотная речь
 owe=должен
 consideration/account=внимание
 get to=обраться до
 degree/extent=степень
 state=утверждать
 statement=утверждение
 transpose=транспонировать
 assume=предполагать
 least=наименее
 however=однако
 possession=владение/обладать
 change=сдача